NO ./assets/textures/no.xpm
SO ./assets/textures/so.xpm
WE ./assets/textures/we.xpm
EA ./assets/textures/ea.xpm

F 23,23,23
C 9,106,167

 1111111        111111111
110000011      10000000001
100000001     1000000000001
 1000001     100000000000001
  11011      1000000000000001
   101        1000000100000001
   101         1000010100000001
   101111111111100000100000001
   100000000000000W0000000001
   1011111111111000000000001
   101         100000000001
   101        100000000001
  11011      100000000001
 1000001     100000000001
100000001     10000000001
110000011      1000000001
 1111111        111111111