NO ./assets/textures/no.xpm
SO ./assets/textures/so.xpm
WE ./assets/textures/we.xpm
EA ./assets/textures/ea.xpm

F 23,23,23
C 9,106,167

    11111111111111
   100000000000001
  10000000000000011
 1000000000000000001
10000001111111000001
100000010000010000001
100000010000010000001
1000000100E0010000001
100000010000010000001
100000011101110000001
 11000000000000000001
  100000000000000011
  1000000000000011
  10000000000011
  111111111111