NO ./assets/textures/no.xpm
SO ./assets/textures/so.xpm
WE ./assets/textures/we.xpm
EA ./assets/textures/ea.xpm

F 23,23,23
C 9,106,167

 111111111111      111111111
1000000000001    110000000011
100000000000011110000000000001
1000000000000000000000000000001
100000000000011110000000000001
100000000000001  1000001000001
10000011111000011100000000001
100000D00001E00D00000011100001
10000011111000011100000000001
100000000000001  100000000001
100000000000011110000000000001
1000000000000000000000000000001
100000000000011110000000000001
1000000000001    110000000011
 111111111111      111111111