NO ./assets/textures/no.xpm
SO ./assets/textures/so.xpm
WE ./assets/textures/we.xpm
EA ./assets/textures/ea.xpm

F 220,100,0
C 225,30,0

                    111111111111111
                    100000000000001
                111111111000111111111111
                100000001000100000000001
           111111000000001000100111111111111
           100000000111001000100100000000001
      111111011111111111001000100111111110111111
      100000010000000001001000100000001000000001
 111111011110110111110001000111111001001111111111
 100000010000100100000001000000001001000000000001
 101111110000100101111111111111001001000111111101
 100000000000100100000000000001001001000100000101
 111111111111100111111111111101001001000101110101
 100000000000100000000000000101001001000101010101
11011111111110111111111111110101001001000101010101
10N00000000000000000000000000101001001000101010101
11111111111111111111111111111101001001000101010101
          1000000000000000000001001001000101010101
          1011111111111111111111001001000101010101
          1000000000000000000000001001000101010101
          1111111111111111111111111001000101010101
                             100000001000101010101
                             101111111000101010101
                             100000000000101010101
                             111111111111101010101
                                  100000000010101
                                  101111111110101
                                  100000000000101
                                  111111111111111